10 12
7 7 7 7 7 7 7 7 7 7
2 2 2 2 2 2 2 2 2 2
3 3 3 3 3 3 3 3 3 3
1 4 1 4 1 4 1 4 1 4
5 5 5 5 5 5 5 5 5 5
0 0 0 0 0 0 0 0 0 0
0 0 0 0 0 0 0 0 0 0
0 1 0 0 0 0 0 0 0 0
0 0 0 0 0 0 0 0 0 0
0 0 0 0 0 0 0 0 0 0
0 0 0 0 0 0 0 0 0 0
0 0 0 0 0 0 0 0 0 0
